NO		assets/textures/woodwall.xpm
SO 		assets/textures/woodwall.xpm
EA		assets/textures/paperwall.xpm
WE 		assets/textures/paperwall.xpm
F		assets/parquet.xpm
C		assets/moonlight.xpm




                                                        111
                                                       10G01
                                                       10001
                                                       10001
                                                       10001
                                                       10001
                                                       10001
                                                    11100000111
                                                  110000000000011
11111111                                         10000000000000001
1000000111111111                                1000000000000000001
1000000111111111                                1000000000000000001
10E0000D000000001            111111111111      100000000000000000001
100000011100000001     1111111000000000C1      100000000000000000001
10000001  1000000011111100000000000000001      100000000000000000001
11111111   100000000C111000000000000000L1111111000000000000000000000111111
            100000000111000000000000000010000000000000000000000000000000001
            100000000111000000000000000CDG0000000000000000000T00000000000G1
             10000000CD0000000000111111110000000000000000000000000000000001
              11111111111111111111      1111111000000000000000000000111111
                                               100000000000000000001
                                               100000000000000000001
                                               100000000000000000001
                                                1000000000000000001
                                                1000000000000000001
                                                 10000000000000001
                                                  110000000000011
                                                    11100000111
                                                       10001
                                                       10001
                                                       10001
                                                       10001
                                                       10001
                                                       10G01
                                                        111