EA assets/textures/lol.xpm
WE assets/textures/lol.xpm
NO assets/textures/wall.xpm
SO assets/textures/wall.xpm
F assets/textures/wall.xpm
C assets/textures/wall.xpm

11111111111111111111111111111111111111111111111111111111111111111111111111111111111111111111111111111111111111111111111111111111111111111111111111111111111111111111111111
100000000000000000000000000000000000000000000000000000000000000000000000000000000000000000000000000000000000000000000000000000000000000000000000000000000000000000000000W1
11111111111111111111111111111111111111111111111111111111111111111111111111111111111111111111111111111111111111111111111111111111111111111111111111111111111111111111111111