EA assets/textures/lol.xpm
WE assets/textures/lol.xpm
NO assets/textures/paperwall.xpm
SO assets/textures/woodwall.xpm
F assets/textures/wall.xpm
C assets/moonlight.xpm

11111111111111111111111111111111111111111111111111111111111111111111111111111111111111111111111111111111111111111111111111111111111111111111111111111111111111111111111111
1000000000000000000000000000000000000000000000000000000000000000000000000000000000000000000000000000000000000000000000000000000000000000000000000000000000000000L0000000W1
11111111111111111111111111111111111111111111111111111111111111111111111111111111111111111111111111111111111111111111111111111111111111111111111111111111111111111111111111